sequence	label
AAAQAA	negative
AAELRN	negative
AAIDWF	negative
AAIGWG	negative
AALQSS	negative
AAPKPK	negative
AAQAAL	negative
AARRFF	negative
AAVDQT	negative
ACGVIG	negative
ADVGQG	negative
ADVSIE	negative
AEKLFD	negative
AEMEYL	negative
AENGKS	negative
AESDKK	negative
AETKEP	negative
AEVLAL	negative
AFSINP	negative
AGFQPQ	negative
AGGYYQ	negative
AGSGSG	negative
AGYQQQ	negative
AIDWFD	negative
AIGWGS	negative
AINKIQ	negative
AISNNN	negative
ALALQT	negative
ALQSSW	negative
ALQTDA	negative
AMMAAA	negative
AMNITN	negative
ANATKK	negative
ANNNSN	negative
ANNYSS	negative
APKPKK	negative
AQAALQ	negative
AQAQPA	negative
AQIVYK	negative
AQPAGG	negative
ASNAGS	negative
ASQQNQ	negative
ASRQNQ	negative
ATAHQY	negative
ATKKVD	negative
ATLDQW	negative
ATTRTV	negative
ATVSFD	negative
AVDQTA	negative
AVTTGV	negative
AYNAQA	negative
CPSGNN	negative
DADLYL	negative
DAGYQQ	negative
DATVYV	negative
DDSLFF	negative
DECFFF	negative
DENNTF	negative
DETVIV	negative
DFQKQQ	negative
DIEVDL	negative
DILTYT	negative
DKKEEE	negative
DLLKNG	negative
DLTITQ	negative
DLTQRG	negative
DNNTIF	negative
DQTASN	negative
DQWNGK	negative
DSNQGN	negative
DTKPAE	negative
DVGQGS	negative
DVNRNG	negative
DVSIED	negative
EALYLV	negative
EATVSF	negative
EATVYV	negative
ECFFFE	negative
EDSVIS	negative
EECLFL	negative
EEEKSA	negative
EEKKEE	negative
EEKPVQ	negative
EEKSAE	negative
EEKSEL	negative
EEPVKK	negative
EHSDLS	negative
EKDEYA	negative
EKKEEK	negative
EKNLYL	negative
EKPVQT	negative
EKSAET	negative
EKSELP	negative
ELNIYQ	negative
ELPKVE	negative
EMTVKQ	negative
EPTKVE	negative
EPTREP	negative
EPVKKE	negative
ERGFFY	negative
ERIEKV	negative
ESDKKE	negative
ESNTNN	negative
ETKEPT	negative
ETVIVI	negative
ETWFFG	negative
EVDLLK	negative
EVTTGV	negative
EYLKIA	negative
FERQHM	negative
FFNLNN	negative
FFWRFM	negative
FFYTPK	negative
FGAFSI	negative
FGELFE	negative
FGGGNG	negative
FGNNAT	negative
FGNQSG	negative
FGNSAT	negative
FGNSRG	negative
FGTFSI	negative
FHPSDI	negative
FINYTN	negative
FKQIGI	negative
FLKYFT	negative
FMFFII	negative
FMFNDL	negative
FMSNDL	negative
FNKFGG	negative
FNPQGG	negative
FNYNNN	negative
FQKQQK	negative
FQPQSQ	negative
FSKDWS	negative
FSNATN	negative
FTPTEK	negative
FVNQHL	negative
FYTPKT	negative
GAAIGW	negative
GAAVDQ	negative
GADVGQ	negative
GAFSIN	negative
GEATVS	negative
GERGFF	negative
GFFNLQ	negative
GFFYTP	negative
GFGNNA	negative
GFGNQS	negative
GFGNSA	negative
GFGNSR	negative
GFNKFG	negative
GFNNSA	negative
GFNNTP	negative
GFPGSF	negative
GFQPQS	negative
GFSGSF	negative
GFSNNN	negative
GGFGNQ	negative
GGFNKF	negative
GGGGNH	negative
GGGGNN	negative
GGGMNF	negative
GGGNGA	negative
GGGNHG	negative
GGGNSA	negative
GGMNFG	negative
GGNGAA	negative
GGNGAD	negative
GGNHGG	negative
GGNNSG	negative
GGNSAL	negative
GGQQQS	negative
GGRGNY	negative
GGYQQQ	negative
GGYQQY	negative
GGYYQN	negative
GIIKTN	negative
GIKLAN	negative
GKQAYQ	negative
GKQGYQ	negative
GLLLWQ	negative
GMFNIQ	negative
GMLASQ	negative
GMLASR	negative
GMNFGA	negative
GMNFGT	negative
GMSLND	negative
GNGAAV	negative
GNGADV	negative
GNHGGG	negative
GNNATA	negative
GNNQQN	negative
GNNRYQ	negative
GNNSGP	negative
GNNSYS	negative
GNQQQG	negative
GNQSGF	negative
GNSALA	negative
GNSATL	negative
GNYKNF	negative
GQGSDD	negative
GQIVYK	negative
GQNNTQ	negative
GQQNQY	negative
GQQQSY	negative
GQQSYS	negative
GQSSYS	negative
GRGNYK	negative
GRIGIA	negative
GSASNA	negative
GSGFNG	negative
GSGSGF	negative
GSHLVE	negative
GSNNTF	negative
GSNSGA	negative
GTFFQE	negative
GTFSIN	negative
GVFNNQ	negative
GVNNNN	negative
GVPGIA	negative
GVTIIT	negative
GVVPQY	negative
GVVVVT	negative
GWGSAS	negative
GYGQSS	negative
GYQAGF	negative
GYQAYN	negative
GYQQGG	negative
GYQQQF	negative
GYQQQY	negative
GYQQYN	negative
GYSGYQ	negative
GYYQNY	negative
HAFLII	negative
HGGGGN	negative
HGGGNG	negative
HIFIIM	negative
HKALFW	negative
HLVEAL	negative
HNNNNN	negative
HNNNSQ	negative
HNSVNF	negative
HNTNNA	negative
HPAENG	negative
HQIVYK	negative
HTAVTT	negative
HWQNFA	negative
HWRNFA	negative
ICSLYQ	negative
IDLTQR	negative
IEDSVI	negative
IEKVEH	negative
IFNYNN	negative
IGIIKT	negative
IGNNSI	negative
IGRTLV	negative
IGRTLW	negative
IGWGSA	negative
IHKAQN	negative
IINFEQ	negative
IIPFEQ	negative
IITVTN	negative
IKLANA	negative
ILENIS	negative
ILGSNN	negative
INLYTD	negative
INNMTN	negative
INNVSN	negative
INPAMM	negative
IQNNSN	negative
IQRTPK	negative
IQVYSR	negative
ISLSGD	negative
ISMTTS	negative
ITQHGG	negative
ITVTND	negative
IVIRTP	negative
IVIVAT	negative
IYFNVQ	negative
KAAIDW	negative
KAFIIQ	negative
KAILFL	negative
KECLIN	negative
KEEEKS	negative
KEEKPV	negative
KEEKSE	negative
KENIIF	negative
KEPTRE	negative
KGENFT	negative
KKEEEK	negative
KKEEKP	negative
KKEEKS	negative
KKTLKL	negative
KKVDTK	negative
KLANAT	negative
KLLEIA	negative
KLVSSS	negative
KMFFIQ	negative
KNFNYN	negative
KPAESD	negative
KPKKTL	negative
KPVQTE	negative
KQAAPK	negative
KQFGGG	negative
KQQKQA	negative
KSAETK	negative
KSELPK	negative
KSNFLN	negative
KTLKLV	negative
KTVIIT	negative
KTVIVE	negative
KTVIYE	negative
KTVLIE	negative
KVDTKP	negative
KVEDLK	negative
KVEEPV	negative
KVEHSD	negative
KWDRDM	negative
KYLNWD	negative
KYNNTG	negative
LADVYV	negative
LAEAIG	negative
LAEVYV	negative
LAKVYV	negative
LALQTD	negative
LANATK	negative
LAPVYV	negative
LARVYV	negative
LASQQN	negative
LASRQN	negative
LATAYV	negative
LATDYV	negative
LATEYV	negative
LATGYV	negative
LATHYV	negative
LATKYV	negative
LATNYV	negative
LATPYV	negative
LATQYV	negative
LATRYV	negative
LATSYV	negative
LATTYV	negative
LATVYA	negative
LATVYD	negative
LATVYG	negative
LATVYH	negative
LATVYK	negative
LATVYL	negative
LATVYP	negative
LATVYQ	negative
LATVYR	negative
LATVYS	negative
LATVYT	negative
LATWYV	negative
LDGFSR	negative
LDGSSR	negative
LDQWNG	negative
LDTVYV	negative
LETVYV	negative
LFMFND	negative
LFMSND	negative
LFNNST	negative
LGNNSN	negative
LIAGFN	negative
LINNSV	negative
LKLVSS	negative
LKNGER	negative
LKTVYV	negative
LLFCHI	negative
LLFYHI	negative
LLGPTI	negative
LLNKTN	negative
LLVPTI	negative
LMNTTN	negative
LMSLFG	negative
LNDFQK	negative
LNNITA	negative
LPKVED	negative
LQGYQA	negative
LQNVSN	negative
LQSSWG	negative
LQTDAR	negative
LRTVYV	negative
LSGDHC	negative
LSQPKI	negative
LTFIQV	negative
LTITQH	negative
LTQRGF	negative
LVSSSG	negative
MAAAQA	negative
MERLRI	negative
MEWLRI	negative
MGGGMN	negative
MGMLAS	negative
MGNNTV	negative
MINLYT	negative
MLASQQ	negative
MLASRQ	negative
MMAAAQ	negative
MMGMLA	negative
MNFGAF	negative
MNFGTF	negative
MSDSNQ	negative
MSLNDF	negative
MTVKQF	negative
MYFFIF	negative
MYWIIF	negative
NAGSGS	negative
NANASS	negative
NANTSN	negative
NAQAQP	negative
NATAHQ	negative
NATKKV	negative
NDFQKQ	negative
NDNNNN	negative
NDNNSN	negative
NENGNA	negative
NFFIQS	negative
NFFWLL	negative
NFGAFS	negative
NFGTFS	negative
NFNNGN	negative
NFNYNN	negative
NGAAVD	negative
NGADVG	negative
NGERIE	negative
NGIVIV	negative
NGKSNF	negative
NGNLSN	negative
NGNLTS	negative
NGNNSN	negative
NGNQNR	negative
NGNQQQ	negative
NHGGGG	negative
NIDQSF	negative
NIGNNS	negative
NIGQSF	negative
NININV	negative
NINNNN	negative
NINNSI	negative
NINNST	negative
NIQYQF	negative
NISNNN	negative
NIVLIM	negative
NIYQYG	negative
NKFGGP	negative
NLGPVL	negative
NLQGYQ	negative
NLYTDR	negative
NMGGGM	negative
NMNMNL	negative
NNATAH	negative
NNGGNN	negative
NNLQGY	negative
NNNGNQ	negative
NNNISN	negative
NNNISV	negative
NNNKNN	negative
NNNLQG	negative
NNNNNE	negative
NNNNSN	negative
NNNNTN	negative
NNNRGG	negative
NNNSSS	negative
NNQQNY	negative
NNRYQG	negative
NNSYSG	negative
NNTIFV	negative
NPAMMA	negative
NPDAGY	negative
NPQGGR	negative
NPQGGY	negative
NQGNNQ	negative
NQGYNT	negative
NQNMNN	negative
NQQNYQ	negative
NQQQGN	negative
NQSCPS	negative
NQSGFG	negative
NQYNSS	negative
NRYQGY	negative
NSALAL	negative
NSATLD	negative
NSGAAI	negative
NSNINQ	negative
NSNLTA	negative
NSNNSN	negative
NSNSSN	negative
NSNTNT	negative
NSNTTK	negative
NSNYTQ	negative
NSSFNG	negative
NSYSGS	negative
NTIFVQ	negative
NTNNTS	negative
NVAMHV	negative
NVAVHV	negative
NVNFSN	negative
NVTQVG	negative
NYFAIR	negative
NYKNFN	negative
NYNNNL	negative
NYNNSG	negative
NYNNSS	negative
NYNTYR	negative
NYQGYS	negative
NYQQYS	negative
PAESDK	negative
PAGGYY	negative
PAMMAA	negative
PATVYV	negative
PDAGYQ	negative
PGGFGN	negative
PKIQVY	negative
PKKTLK	negative
PKPKKT	negative
PKVEDL	negative
PMINLY	negative
PNGITL	negative
PNSANS	negative
PNVITL	negative
PQGGRG	negative
PQGGYQ	negative
PQIVYK	negative
PQSQGM	negative
PQYGGG	negative
PSDIEV	negative
PSGNNQ	negative
PTEKDE	negative
PTKVEE	negative
PTRCCP	negative
PTREPT	negative
PTVIIE	negative
PVKKEE	negative
PVQTEE	negative
PYGQQS	negative
QAALQS	negative
QAAPKP	negative
QAGFQP	negative
QAQNQW	negative
QAQPAG	negative
QAYNAQ	negative
QFGGGN	negative
QFNPQG	negative
QGFNNQ	negative
QGGRGN	negative
QGGYQQ	negative
QGMSLN	negative
QGNNQQ	negative
QGNNRY	negative
QGYQAG	negative
QGYQAY	negative
QGYSGY	negative
QHGGGN	negative
QIGIIK	negative
QKQAAP	negative
QKQQKQ	negative
QLFINN	negative
QNGNQQ	negative
QNQSCP	negative
QNQSGP	negative
QNQYNS	negative
QNSLNM	negative
QNYQGY	negative
QNYQQY	negative
QPAGGY	negative
QPKIVK	negative
QPMINL	negative
QPQSQG	negative
QQFNPQ	negative
QQGGYQ	negative
QQGNNR	negative
QQKQAA	negative
QQNQSC	negative
QQNQSG	negative
QQNQYN	negative
QQNTSF	negative
QQNYQQ	negative
QQNYSK	negative
QQQFNP	negative
QQQGNN	negative
QQQSYG	negative
QQQSYN	negative
QQQYNP	negative
QQSYGQ	negative
QQSYNP	negative
QQSYSG	negative
QQYNPD	negative
QQYNPQ	negative
QQYSQN	negative
QRGFGN	negative
QSCPSG	negative
QSGFGN	negative
QSQGMS	negative
QSSWGM	negative
QSSYSS	negative
QSYGQQ	negative
QSYNPP	negative
QSYSGY	negative
QTDARN	negative
QTEEKK	negative
QTFNLF	negative
QTNLYG	negative
QVGFGN	negative
QVVHIG	negative
QVVPIG	negative
QWNGKN	negative
QYGGGG	negative
QYGGGN	negative
QYNNSN	negative
QYNPDA	negative
QYNPQG	negative
QYSQNG	negative
REPTKV	negative
RETWFF	negative
RGFFYT	negative
RGFGNS	negative
RGGFNK	negative
RGNYKN	negative
RIGIAQ	negative
RLSNNI	negative
RLVFID	negative
RMFNII	negative
RNLTKD	negative
RQFNQT	negative
RQIVYK	negative
RQNQSG	negative
RTPKIQ	negative
RVAFFE	negative
RVNHVT	negative
RVNNNA	negative
RYQGYQ	negative
SAETKE	negative
SASNAG	negative
SATLDQ	negative
SCNNNN	negative
SCPSGN	negative
SDKKEE	negative
SDLSFS	negative
SDLTIT	negative
SDNNTI	negative
SDSNQG	negative
SELPKV	negative
SEMTVK	negative
SGAAIG	negative
SGDHCI	negative
SGFGNS	negative
SGFHPS	negative
SGIKLA	negative
SGSGFN	negative
SGSNSG	negative
SGYQQG	negative
SHLVEA	negative
SHVIIE	negative
SIDLTQ	negative
SIEDSV	negative
SINPAM	negative
SKVIIE	negative
SLNDFQ	negative
SLSGDH	negative
SLYQLE	negative
SNAGSG	negative
SNGIVI	negative
SNMGGG	negative
SNNFGA	negative
SNNSNI	negative
SNQGNN	negative
SNSGAA	negative
SNTNNT	negative
SPVIIE	negative
SQGMSL	negative
SQNGNQ	negative
SQQNQS	negative
SRHPAE	negative
SRQNQS	negative
SRVIIE	negative
SSGIKL	negative
SSIDLT	negative
SSNNNS	negative
SSSGIK	negative
SSVNVT	negative
SSWGMM	negative
SSYSSY	negative
STADWE	negative
STAIIE	negative
STDIIE	negative
STFTIE	negative
STGIIE	negative
STHIIE	negative
STIIIE	negative
STKIIE	negative
STLIFE	negative
STLIYE	negative
STLLIE	negative
STLLYE	negative
STLTFE	negative
STLTIE	negative
STMIIE	negative
STNIFE	negative
STNIYE	negative
STNNTN	negative
STNSNT	negative
STNTFE	negative
STNTIE	negative
STPIIE	negative
STQIFE	negative
STQIYE	negative
STRIIE	negative
STTIIE	negative
STTVVT	negative
STVAIE	negative
STVDIE	negative
STVGIE	negative
STVHIE	negative
STVIAE	negative
STVIDE	negative
STVIEE	negative
STVIGE	negative
STVIHE	negative
STVIIH	negative
STVIIK	negative
STVIIP	negative
STVIIR	negative
STVIKE	negative
STVIKT	negative
STVILE	negative
STVIME	negative
STVINE	negative
STVIPE	negative
STVIQE	negative
STVIRE	negative
STVISE	negative
STVITE	negative
STVIVE	negative
STVIWE	negative
STVKIE	negative
STVMIE	negative
STVPIE	negative
STVQIE	negative
STVRIE	negative
STVSIE	negative
STVTFE	negative
STVVIE	negative
STWTFE	negative
STWTIE	negative
STYIIE	negative
SVISLS	negative
SVNVTQ	negative
SWGMMG	negative
SWVIIE	negative
SYLCDL	negative
SYLYDL	negative
SYNNNN	negative
SYSGSN	negative
TAAHCF	negative
TAELIT	negative
TAVHCF	negative
TAVTTG	negative
TAWYAE	negative
TDETVI	negative
TEEKKE	negative
TEFTPT	negative
TFSINP	negative
TFWEIS	negative
TGVTII	negative
TGVVVV	negative
TITQHG	negative
TKEPTR	negative
TKKVDT	negative
TKPAES	negative
TKVEEP	negative
TLDQWN	negative
TLKLVS	negative
TLKNYI	negative
TNELYM	negative
TNNNTN	negative
TQHGGG	negative
TQRGFG	negative
TQVGFG	negative
TREPTK	negative
TRNNTV	negative
TTGVTI	negative
TTGVVV	negative
TTVVST	negative
TTVVTT	negative
TVFHIG	negative
TVFPIG	negative
TVIVIR	negative
TVKQFG	negative
TVVSTT	negative
TYQIIR	negative
VAMHVF	negative
VANNST	negative
VATTRT	negative
VAWLKM	negative
VDQTAS	negative
VDTKPA	negative
VEDLKI	negative
VEEPVK	negative
VFFINQ	negative
VGFGNN	negative
VGQGSD	negative
VHNNSN	negative
VISLSG	negative
VIVIRT	negative
VIWIAQ	negative
VKKEEK	negative
VKQFGG	negative
VKWDRD	negative
VNNNNI	negative
VNNNNN	negative
VNWCER	negative
VNWYER	negative
VPGIAQ	negative
VPIVYK	negative
VPQYGG	negative
VQAVYK	negative
VQDVYK	negative
VQEVYK	negative
VQGVYK	negative
VQHVYK	negative
VQIAYK	negative
VQIEYK	negative
VQIGYK	negative
VQIHYK	negative
VQIPYK	negative
VQKVYK	negative
VQPVYK	negative
VQRVYK	negative
VQSVYK	negative
VQTEEK	negative
VQWVYK	negative
VQYVYK	negative
VSIEDS	negative
VSNLSN	negative
VSSSGI	negative
VTIITV	negative
VTLSQP	negative
VTQEFW	negative
VTTGVT	negative
VTTGVV	negative
VTTVVS	negative
VVPQYG	negative
VVTSEE	negative
VVVTSE	negative
VVVVTS	negative
VYSCEW	negative
VYSRHP	negative
VYSWEW	negative
WGMMGM	negative
WGSASN	negative
WNFGTQ	negative
WNFSTQ	negative
WPNGIT	negative
WSFYLL	negative
WVENYP	negative
WYFYIQ	negative
YASEIE	negative
YASNNN	negative
YGGGGN	negative
YGGGNS	negative
YGQQNQ	negative
YGQQQS	negative
YGQQSY	negative
YGQSSY	negative
YIFNNM	negative
YKNFNY	negative
YLEIII	negative
YLGNNS	negative
YNAQAQ	negative
YNNNLQ	negative
YNNTGS	negative
YNPDAG	negative
YNPQGG	negative
YQAGFQ	negative
YQAYNA	negative
YQGYQA	negative
YQGYSG	negative
YQLENY	negative
YQNYQG	negative
YQQGGY	negative
YQQQFN	negative
YQQQYN	negative
YQQYNP	negative
YQQYSQ	negative
YQYGGG	negative
YSGSNS	negative
YSGYQQ	negative
YSQNGN	negative
YTFTIS	negative
YTNISN	negative
YVSGFH	negative
YYNYNN	negative
YYQNYQ	negative
YYTEFT	negative
KSHPET	negative
SGDGSL	negative
EIPAGV	negative
DAVKIS	negative
ETYVVT	negative
TYSFYC	negative
NKGAIK	negative
VTKVAK	negative
YYQNYQ	positive
YVEYIG	positive
YTVIIE	positive
YQLIWQ	positive
YQIVYK	positive
YNNYNN	positive
YLVNFT	positive
YLNWYQ	positive
YLLYYT	positive
YLLWYC	positive
YLFLQY	positive
YIFNNC	positive
YHLAMA	positive
YATVYV	positive
YAELIV	positive
WVFWIG	positive
WTVNYS	positive
WTVIIE	positive
WTFNLY	positive
WQIVYK	positive
WPNVIT	positive
WIVIFF	positive
WATVYV	positive
VYIVYK	positive
VYIMIG	positive
VWIVYK	positive
VVSTTV	positive
VVIVYK	positive
VVFFIC	positive
VTVQAT	positive
VTVIIE	positive
VTSTFS	positive
VTQVGF	positive
VTLWWG	positive
VTLHAT	positive
VTIVYK	positive
VTFTIQ	positive
VSTTVV	positive
VSIVYK	positive
VSFLSA	positive
VSFEIV	positive
VRIVYK	positive
VQVVYK	positive
VQTVYK	positive
VQQVYK	positive
VQNVYK	positive
VQMVYK	positive
VQLVYK	positive
VQIYYK	positive
VQIWYK	positive
VQIVYY	positive
VQIVYW	positive
VQIVYV	positive
VQIVYT	positive
VQIVYS	positive
VQIVYR	positive
VQIVYQ	positive
VQIVYP	positive
VQIVYN	positive
VQIVYM	positive
VQIVYL	positive
VQIVYK	positive
VQIVYI	positive
VQIVYH	positive
GGYMLG	positive
GGYLLG	positive
GGVVIA	positive
GGVLVN	positive
GGGNNS	positive
GFFQQQ	positive
GEWTYD	positive
GELAVA	positive
GDVIEV	positive
IVATTR	positive
ITVIIE	positive
ITLFWG	positive
ISFLIF	positive
IQIVYK	positive
IQIMIW	positive
ILVAGS	positive
ILVAGD	positive
ILQINS	positive
IINFIT	positive
IIHFGS	positive
IFQINS	positive
IFDFIQ	positive
IEMIFV	positive
IATVYV	positive
HYFNIF	positive
HTVIIE	positive
HTFNLL	positive
HSSNNF	positive
HQLIIM	positive
HQFNLN	positive
HLVYIM	positive
HLFNLT	positive
HIFLLC	positive
HICNFF	positive
HGWLIM	positive
HGFNQQ	positive
HFVWIA	positive
HATVYV	positive
GYVLGS	positive
GYVIIK	positive
GYMLGS	positive
GYFLNM	positive
GYFLNF	positive
GYFILQ	positive
GYCFIL	positive
GVWWFF	positive
GVVTSE	positive
GVQVGD	positive
GVNYFL	positive
GVIWIA	positive
GVIGIA	positive
GVATVA	positive
GTVWWG	positive
GTVLFM	positive
GTVIIE	positive
GTLVFM	positive
GTLFWG	positive
GTFNII	positive
GTFFIT	positive
GTFFIN	positive
GSIAAT	positive
GNVCIN	positive
GNVAVA	positive
GNTCVN	positive
GNFNNL	positive
GNCFIL	positive
GMMGML	positive
GLSIFV	positive
GLFINM	positive
GLCYFN	positive
GIVIVA	positive
GIFNIK	positive
GGYVLG	positive
DQIVYK	positive
CILFWG	positive
AIVAGS	positive
GDHCII	positive
FQIVYK	positive
DSVISL	positive
CQIVYK	positive
AIVAGT	positive
FLVHSS	positive
LATVYI	positive
LATVYF	positive
LATVYE	positive
LATVYC	positive
LATVWV	positive
LATVVV	positive
LATVTV	positive
LATVSV	positive
LATVRV	positive
LATVQV	positive
LATVPV	positive
LATVNV	positive
LATVMV	positive
LATVLV	positive
LATVKV	positive
LATVIV	positive
LATVHV	positive
LATVGV	positive
LATVFV	positive
LATVEV	positive
LATVDV	positive
LATVCV	positive
LATVAV	positive
LATMYV	positive
LATLYV	positive
LATIYV	positive
LATFYV	positive
LATCYV	positive
LASVYV	positive
LAQVYV	positive
LANVYV	positive
LANFLV	positive
LAMVYV	positive
LALVYV	positive
LAIVYV	positive
LAHVYV	positive
LAGVYV	positive
LAFVYV	positive
LACVYV	positive
LAAVYV	positive
KVQIIN	positive
KTVIIE	positive
KTVEGA	positive
KTKQGV	positive
KTKEQV	positive
KTKEGV	positive
KQIVYK	positive
KQIGII	positive
KNFNYN	positive
KNEEGA	positive
KLVFFA	positive
KLLIYE	positive
KLFIQF	positive
KLFIIQ	positive
KIVKWD	positive
KHIIVA	positive
KDWSFY	positive
KCWCFT	positive
KCLNYL	positive
KATVYV	positive
KAKEGV	positive
IYQYGG	positive
IVYSWE	positive
IVYSCE	positive
AIVAGD	positive
AILSST	positive
AIIGLM	positive
AGVNYF	positive
AEVVFT	positive
AATVYV	positive
AAIIGQ	positive
IIGLMV	positive
GDCFIL	positive
NHFCIQ	positive
NFVNYS	positive
NFLVHS	positive
NFGSVQ	positive
NFGEFS	positive
NFGAIL	positive
NATVYV	positive
MVGGVV	positive
MTVIIE	positive
MTFIQN	positive
MQIVYK	positive
MMHFGN	positive
MLVLFV	positive
MIHFGN	positive
MIENIQ	positive
MHVNIQ	positive
MCSIFQ	positive
MATVYV	positive
LYVLIV	positive
LYTVYV	positive
LYQLEN	positive
LWTVYV	positive
LVTVYV	positive
LVHSSN	positive
LVFYQQ	positive
LVEALY	positive
LTVIIE	positive
LTTVYV	positive
LSTVYV	positive
LSFSKD	positive
LQTVYV	positive
LQIVYK	positive
LPTVYV	positive
LNTVYV	positive
LNIYQY	positive
LMTVYV	positive
LLYYTE	positive
LLTVYV	positive
LLAVVA	positive
LKVKVL	positive
LIVAGT	positive
LIVAGS	positive
LIVAGK	positive
LIVAGE	positive
LIVAGD	positive
LIVAAD	positive
LITVYV	positive
LIFLIV	positive
LHTVYV	positive
LGTVYV	positive
LFTVYV	positive
LEFWLQ	positive
LCTVYV	positive
LAYVYV	positive
LAWVYV	positive
LAVVYV	positive
LAVLFL	positive
LAVAGD	positive
LATYYV	positive
LATVYY	positive
LATVYW	positive
LATVYV	positive
LATVYN	positive
LATVYM	positive
CGVIGI	positive
CATVYV	positive
AVFIIY	positive
ATVQAF	positive
ATVIIE	positive
ASSSNY	positive
AQFIIS	positive
ANFLVH	positive
ALEEYT	positive
SSNNFG	positive
SQVIIE	positive
SQIVYK	positive
SQFYIT	positive
SQAIIH	positive
SNVIIE	positive
SNQNNF	positive
SMVLFS	positive
SMVIIE	positive
SLVIIE	positive
SIVIIE	positive
SGVIIE	positive
SFVIIE	positive
SFQIYA	positive
SFLIFL	positive
SFFFIQ	positive
SEVIIE	positive
SELNIY	positive
SDVIIE	positive
SAVIIE	positive
SATVYV	positive
SALALQ	positive
RVFNIM	positive
RTVIIE	positive
RQVLIF	positive
RATVYV	positive
QYGGNN	positive
QYGGNA	positive
QYFEQF	positive
QTVIIE	positive
QTFLVN	positive
QQSLFQ	positive
QQIVYK	positive
QNLLWQ	positive
QLFLQI	positive
QLFINF	positive
QLENYC	positive
QILLWS	positive
QGVCFR	positive
QFFLQF	positive
QEMRHF	positive
QATVYV	positive
QANKHI	positive
NYVWIV	positive
NYCNFV	positive
NTVIIE	positive
NQQNQY	positive
NQNNFV	positive
NQIVYK	positive
NQFNLM	positive
NQFIIS	positive
NNSGPN	positive
NNQQNY	positive
NNQNTF	positive
NNNWSL	positive
NLFYQL	positive
NKGAII	positive
NINKSN	positive
NINFIT	positive
NINFFT	positive
NIFWVQ	positive
NIFNIT	positive
NIFNFT	positive
NHVTLS	positive
DIDLHL	positive
DHCIIW	positive
DHCIIG	positive
DFNKFH	positive
DCVNIT	positive
CTVWWG	positive
CTVFIG	positive
CTLWWG	positive
CTIYWG	positive
VAIVYK	positive
VAFNIT	positive
TYVEYI	positive
TTVIIE	positive
TQIVYK	positive
TIITVT	positive
TIITLE	positive
TGELAT	positive
TFQINS	positive
TCVTHR	positive
TCMLGT	positive
TAVVTN	positive
TAVTHR	positive
TATVYV	positive
TASNSS	positive
TAMLGT	positive
TAMIIQ	positive
SYVIIE	positive
SYSTMS	positive
SVVIIE	positive
SVSSSY	positive
SVNLDV	positive
STWLIE	positive
STWIYE	positive
STWIIE	positive
STWIFE	positive
STVYIE	positive
STVWIE	positive
STVTIE	positive
STVNIE	positive
STVLIE	positive
STVIYE	positive
STVIIY	positive
STVIIW	positive
STVIIV	positive
STVIIT	positive
STVIIS	positive
STVIIQ	positive
STVIIN	positive
STVIIM	positive
STVIIL	positive
STVIII	positive
STVIIG	positive
STVIIF	positive
STVIIE	positive
STVIID	positive
STVIIA	positive
STVIFE	positive
STVFIE	positive
STVEIE	positive
STSIIE	positive
STQIIE	positive
STNIIE	positive
STMSIT	positive
STLIIE	positive
STFTFE	positive
STFLIE	positive
STFIIE	positive
STFIFE	positive
STEIIE	positive
SSVIIE	positive
SSTSAA	positive
SSTNVG	positive
SSQVTQ	positive
FIVNIV	positive
FESNFN	positive
FATVYV	positive
FAIRHF	positive
EYSNFS	positive
ETVIIE	positive
EQIVYK	positive
EGVLYV	positive
DTVIIE	positive
VQIVYG	positive
VQIVYF	positive
VQIVYE	positive
VQIVYD	positive
VQIVYC	positive
VQIVYA	positive
VQIVWK	positive
VQIVVK	positive
VQIVTK	positive
VQIVSK	positive
VQIVRK	positive
VQIVQK	positive
VQIVPK	positive
VQIVNK	positive
VQIVMK	positive
VQIVLK	positive
VQIVKK	positive
VQIVIK	positive
VQIVHK	positive
VQIVGK	positive
VQIVFK	positive
VQIVEK	positive
VQIVDK	positive
VQIVCK	positive
VQIVAK	positive
VQITYK	positive
VQISYK	positive
VQIRYK	positive
VQIQYK	positive
VQINYK	positive
VQIMYK	positive
VQILYK	positive
VQIKYK	positive
VQIIYK	positive
VQIINK	positive
VQIFYK	positive
VQIDYK	positive
VQICYK	positive
VQFVYK	positive
VQFLQS	positive
VQCVYK	positive
VNVTQV	positive
VNQLYQ	positive
VNIVYK	positive
VMIVYK	positive
VLVEAQ	positive
VLIVYK	positive
VKIVYK	positive
VIVATT	positive
VILLIS	positive
VIIVYK	positive
VIGIAQ	positive
VIFTIM	positive
VHIVYK	positive
VGIVYK	positive
VFIVYK	positive
VFFNNT	positive
VEIVYK	positive
VEALYL	positive
VDIVYK	positive
VCIVYK	positive
VAVHVF	positive
VATVYV	positive
VANFIT	positive
GATVYV	positive
GAITIG	positive
GAILSS	positive
GAIIGL	positive
FYLLYY	positive
FVFYIF	positive
FTVIIE	positive
FTFIQF	positive
FSINPA	positive
